adjacent - Adjacent means close to or near something. You may consider the people up and down your street to be neighbors, but your next-door neighbor is the person who lives in the house or apartment adjacent to yours.
disrupt - To disrupt is to interrupt or throw something into disorder. If you don't turn your phone off before a play, it might ring and disrupt the actors and the audience.
germinate - To germinate is to grow or to develop. When a tiny seedling cracks through a seed casing and sprouts, it has germinated. The term is used for other things too, like when an idea germinates into a film or book.
insinuate - Insinuate means you imply or suggest something that may or may not be true. If you say things seemed to go wrong about the time your brother took over, you insinuate that he had something to do with the decline.
recompense - Say you loan a few bucks to a friend who is short on cash, and he wins the lottery. Presumably, he'll be able to recompense you, or pay you back what he owes.
sullen - A bad-tempered or gloomy person is sullen. Sullen people are down in the dumps.
truce - When two warring sides decide to call it quits, it's called a truce — an agreement to end the fighting.
alight - The word alight has two distinct meanings: it can mean coming down or settling in a delicate manner, such as a bird perching, or it can be a rather poetic way to describe something that’s on fire (or “afire”).
dynasty - A dynasty is a series of leaders in the same family, like the British Royal Family, or a local business dynasty, in which four generations have made their fortune at the family store.
humdrum - Something humdrum is dull, tedious, and totally boring. If a regular old photography class sounds too humdrum, you might instead sign up for Underwater Photography of Marine Predators. Don't forget your wetsuit!
interminable - Use interminable to describe something that has or seems to have no end. Your math class. Your sister's violin recital. A babysitting job where five kids are going through your purse and the parents didn't leave a number.
renovate - To renovate means to renew or rebuild so that something is in good condition. When you move into an old house, you will probably want to renovate the kitchen and bathrooms.
trickle - To trickle is to weakly flow out of something, like a faucet. A trickle is like a drip.
vicious - Vicious is an adjective that means intentionally harmful or nasty. If you spread vicious rumors about a person, you're telling people things that will hurt her feelings or ruin her reputation. Cut it out!
barren - Drive through a forest that's just been destroyed by a fire, and you'll get an idea of what barren means — stripped of vegetation and devoid of life.
foretaste - 
hurtle - If you forcefully throw or fling something, you hurtle it. In a food fight, you may hurtle chocolate pudding across the room, but be prepared for someone to launch peas at you in retaliation. Duck!
interrogate - To interrogate is to ask someone a bunch of questions. Usually, it’s the police, FBI, or other law-enforcement officials who interrogate suspects, but your father-in-law may interrogate you about your career plans.
resume - If you resume something, you start it again after stopping. You might resume singing an aria after breaking to spit out your gum.
trivial - Something that is trivial is not important or significant, such as the trivial details you shared with me about your trip to the post office this morning.
available - "Is this seat  available?" "Are you  available, or are you married?" As you can tell from these two examples, available means "not busy or not taken."
cater - To cater means to supply food for meetings or celebrations. If you're having a big barbecue party but would rather hang out with your friends than grill, you could pay someone to cater it.
customary - Something customary is done according to practice. When a bride walks down the aisle, it's customary for everyone at the wedding to rise out of respect.
dissuade - When you dissuade someone, you convince that person not to do something: “When Caroline saw Peter's broken leg, she tried to dissuade him from going on the ski trip.”
entrepreneur - An entrepreneur is someone who starts a new business. Little stores and huge companies both have entrepreneurs behind them.
firebrand - When someone is known for being wildly devoted to a cause or idea, they're called a firebrand. A firebrand enjoys pushing buttons and stirring up passions.
hazard - If something is a hazard, it is a potential source of danger. Balloons are fun, but they're a hazard for little kids who might put them in their mouths.
homicide - The noun homicide means a murder. If you kill another person, you are committing a homicide. The level of the homicide is legally defined as murder if the act was intentional and as manslaughter if it was unintentional.
indifference - Indifference is the trait of lacking interest or enthusiasm in things. When you feel indifference for something, you neither like it nor dislike it.
indignant - When you're indignant, you're angry about an unfair situation. If you discovered that a teacher gave ten extra points on a test to all students who sat in the front row, you'd be indignant.
indispensable - Indispensable is a strong adjective for something that you couldn't do without. If you have asthma and you're packing for summer vacation, your inhaler is indispensable, unless you enjoy gasping on the beach.
lubricate - When you lubricate something, you make it a little bit greasy so it can easily move or slide. You might need to lubricate a rusted bolt in order to unscrew it, for example.
mutual - If the feeling is mutual, both of you feel the same the way, like a mutual admiration society. Mutual means shared. In finance it is used to describe trusts or funds that pool the money of many investors to buy securities.
pelt - A pelt is an animal's skin, fur and all. If you are wearing a fur coat, you are really wearing a pelt (hate to break it to you).
plague - When the homeowner described her ant problem as a plague, the exterminator thought she was being a bit melodramatic. After all, a few bugs aren't exactly a huge calamity.
poised - If you're poised you're self-possessed and in full control of your faculties. You're balanced, grounded, and ready for action.
regime - A regime is the ruling government of a country. The amount of freedom and restriction that citizens of a country have can change from regime to regime.
hinder - The verb hinder means to block or put something in the way of, so if you’re in a high-speed car chase with the police, they might put up a blockade to hinder your progress.
transparent - You can see right through something transparent. A window is transparent, but so are the intentions of a Peeping Tom looking through that window.
unscathed - If you walked away from a nasty bike accident without a scratch, you walked away unscathed, meaning you came out unharmed.
animated - Something that seems full of life and movement is said to be animated. Animated films for television and movies include cartoons, Claymation, puppets, and computer-generated images, which are all simulations of living things.
downright - The adjective downright is used to emphasize something, or to mean "utterly." For example, you could say that your brother's loud and junky old car is a downright embarrassment.
indulge - Indulge is a verb that means "to give in to something," like when you indulge your craving for chocolate by eating a big piece of it.
loom - Loom has two distinct meanings. First, a loom is a tool for weaving. Second, to loom is to appear or stand over someone in a threatening way. Don’t loom over the person you’re teaching to weave! You'll just make her nervous.
oration - An oration is a formal speech given in public. You might give the oration at the big party celebrating your grandparents’ 50th anniversary.
singe - To burn something just a little bit is to singe it. If you get too close to your backyard fire pit, you might singe your shirt sleeve.
verify - When you verify something, you show that it's true. Do you have a photograph to verify your claim that there's a dinosaur in your backyard?
brood - A brood is a group of young born at the same time — like a brood of chicks — but your parents might use the word for you and your siblings: "We're taking the whole brood to the movies tonight."
drone - To drone is to make a low, continuous noise that sounds like humming or buzzing. On summer nights, you might hear cicadas drone, and on snowy winter mornings, hear your neighbor's snow blower drone.
constituent - Constituent means part of a whole. The word comes up often in political contexts: constituents are the people politicians have been elected to represent. Elected officials should stay in touch with the needs of their constituents.
luster - Something with luster has a certain kind of sheen or shininess, like the way a new pair of shoes looks right before you step into a pile of mud.
peevish - When you're peevish, you're easily irritated and grumpy. Everything seems to get under your skin.
unique - If something is unique, it's the only one around. You might think getting a nose ring would make you unique, until you see five other people on the street with the same piercing.
hanker - To hanker for something is to crave it, or really want it. On a hot, sunny afternoon, you might hanker for a tall glass of sweet iced tea.
culminate - The verb culminate is used to describe a high point or a climactic stage in a process. For example, the goal of a Major League baseball team is to have their season culminate in a World Series victory.
goad - A goad is a pointy stick or other instrument used to prod something along. To goad is to poke something with that pointy stick. Either way, the pointiness is really essential for making things leap into action.
literate - If you're literate you can read and write, and since you're reading this, that's what you are.
miscellaneous - Something miscellaneous is made up of an odd bunch of things — things you might not expect to go together. A breakfast bar, a DVD, and a credit card bill are miscellaneous items that may be in your backpack.
seethe - If a liquid seethes, it is boiling, but if it's a person who's seething, watch out! He or she is really angry!
upright - Something that's upright stands straight up. When you sit upright, your back is straight and vertical. Even your grandmother would approve of your posture.
alliance - Countries that have an alliance, or agreement, help each other out when in need. That means during times of war, for example, if two countries have an alliance, one will help the other by providing weapons and supplies.
bewilder - To bewilder is to amaze, baffle, dumbfound, flummox, perplex, or stupefy. When you bewilder people, you confuse them.
buffoon - A buffoon is someone whose ridiculous behavior is a source of amusement to others. People you might call a buffoon are a political rival or the guy at work who tells silly jokes at office parties.
controversial - If a politician ran for office on the platform that children should be put to work from age six, his platform is likely to be controversial, meaning it will cause controversy, or a long discussion among people with opposing opinions.
dishearten - If someone tells you not to be disheartened, they want you to stay upbeat and positive. Something that brings you down or steals your sense of hope disheartens you.
fruitless - Fruitless things are futile or pointless. If your search for your missing car keys is fruitless, you don't find them no matter how hard you look.
hostile - If something is hostile, it's unfriendly. If you are zealous about the political causes you believe in, you will be hostile to any suggestion that the other side of the argument is reasonable.
inflammable - Something that is inflammable can be set on fire easily. You dared not light a match after you accidentally spilled gasoline on yourself because you knew you were inflammable.
inflict - When you force an undesirable or harmful event on someone, you inflict it on them. You might prefer that someone inflict some physical pain on you rather than inflict you with the boredom of another trip to the annual flower show.
malignant - For something that's very harmful, especially a tumor that's cancerous, use the term malignant.
mortify - To mortify someone is to cause them extreme embarrassment. Your mother may not have been trying to mortify you when she showed up at your senior prom with a bunch of unicorn balloons, but she did.
orthodox - Orthodox practices or beliefs are generally accepted as true or correct. If you are an orthodox vegetarian, you never, ever eat meat — not like those people who have fish once in a while.
procure - In prison movies, there's always a character who is able to procure all sorts of contraband from the inside––magazines, cigarettes, special soap. If you procure something, you get it or bring it about by special effort.
scurry - Scurry means to move quickly, at a frenzied pace, and often also implies the urge to hide. When you come upon a mouse in your house, chances are it will scurry away.
sodden - Pull out your galoshes. When it's been raining for days, there are puddles everywhere, and the grass is thoroughly soaked, it's safe to say the ground is sodden.
spirited - Someone who's spirited is lively or enthusiastic. It can be challenging to babysit a bunch of spirited four-year-olds, but it's also entertaining.
virtual - The adjective virtual is used to describe something that exists in essence but not in actuality. You may have made a virtual friend on an online gaming site, but don't expect that person to meet you for coffee.
void - A void is empty space, nothingness, zero, zilch. A place that's void of all life forms has no sign of animals, plants, or people.
wayward - Someone wayward is a little stubborn and independent — they're determined to find their own way and are not easily controlled.
wince - A wince is a facial or bodily expression of pain, disgust, or regret. Think of something you've done that was really, really embarrassing or dumb: now feel your face or take a look in the mirror as you wince at the uncomfortable memory.
anecdote - A short, amusing true story is an anecdote. You might come back from a crazy spring break with a lot of anecdotes to tell.
consolidate - Consolidate means to bring together. If you consolidate student loans, you put them all together into one big loan. If you consolidate your childhood toys, you grab them all up and put them in one place. Preferably a toy box.
counterfeit - A counterfeit is a fake or a forgery. If you painted an uncanny copy of the "Mona Lisa" and tried to pass it off as the original, you'd have a counterfeit on your hands.
docile - If someone is docile, he is easily taught or handled. If you suddenly became a trouble-maker in class, your teachers would long for the days when you were sweet and docile.
dominate - If your basketball team is undefeated, you could say that it was able to dominate the competition. To dominate means to be in control or have the power to defeat.
entreat - To entreat is to ask for something that is really important, like when you entreat the jury to spare your life.
fallible - As humans we are all fallible, because fallible means likely to make errors or fail. Nobody's perfect, after all.
fickle - People who are fickle change their minds so much you can't rely on them. If your best friend suddenly decides that she doesn't like you one week, and then the next week she wants to hang out again, she's being fickle.
fugitive - Someone who flees or runs away from the police to avoid capture is a fugitive. "Authorities were looking for three men who escaped from prison today. Authorities believe the three fugitives may be disguised as nuns and advise the public to be careful."
grimy - Grimy things are so dirty that it takes some scrubbing to clean them. You'll probably feel pretty grimy after a day spent trying to fix the engine of an old car.
iota - If you don't care one iota about something, it means you don’t care about it even one little bit. An iota is something very small.
maul - Maul is both the name of a heavy hammer, and also a verb meaning beating and scratching. Tigers, lions, bears––animals with powerful paws and sharp claws, will maul their victims.
potential - If you can describe something as possible but not yet actual, choose the adjective potential. Companies try to reach potential customers through advertising.
radiant - The adjective radiant is useful for describing anything that glows with warmth or light. When you open your eyes on a sunny summer morning and see your curtains glowing with sunlight, you can call them radiant.
rural - Rural means "relating to or characteristic of the country or the people who live there." If you move to a rural area, you won't see a lot of skyscrapers or taxis — but you'll probably see a lot of trees.
substantial - Something substantial is large in size, number, or amount: If you want to say someone spent a lot of money without being too specific, you could say they spent a substantial amount of money.
tactful - If you are tactful, you have a knack for saying the right thing at the right time. A tactful person is appropriate and sensitive, never rude or careless.
tamper - To tamper is to alter or mess with something, usually for a bad reason. Tamper also refers to being nosy about someone's business. Don’t tamper with anything; it’s annoying.
ultimate - The last in a series can be described as the ultimate. A cheeky kid, when asked what she wants to be when she grows up, might say, "I want to be an actress, a singer, and a veterinarian, but my ultimate goal is to be President of the United States."
uncertainty - When you have uncertainty, that means you're not really sure. If you missed a lot of classes and didn't study much, you may have uncertainty about whether you passed your big math test.
anonymous - If you don't know who wrote a poem, the author is anonymous. If you don't know who donated a gift to a museum, it's called an anonymous gift from an anonymous donor. Anonymous means a person unknown.
browse - To browse is to look casually for whatever catches your eye, rather than searching for something specific. Window shopping and scanning the newspaper for interesting headlines are forms of browsing.
dupe - A dupe is a furry, ceremonial hat worn during ancient pagan rituals...or not. Dupe actually means “trick or deceive.” We’re sorry we tried to dupe you into believing the wrong definition.
dynamic - If a person, place, or thing is energetic and active, then it's dynamic. When things are dynamic, there's a lot going on.
eradicate - To eradicate something is to get rid of it, to destroy it, and to kiss it goodbye.
frustrate - When you frustrate someone, you do your best to annoy, confuse, or even torment that poor person. Maybe you constantly change your mind — that's sure to frustrate anyone who tries to make plans with you.
grim - Things that are gloomy, stark, ghastly, and somber are grim. Sunshine, puppies, and rainbows are not grim; zombies, reapers, and mummies are grim. Less scary things like drizzly, foggy days can also be called grim.
inimitable - Use the adjective inimitable to describe someone or something that is so special or unique, it is impossible to duplicate, like that superstar tennis player with the inimitable serve no other player can copy.
makeshift - If you have to use a garbage can lid as a sled or a set of drapes as a ball gown, then you know what it means to put together a makeshift creation. Something makeshift has been improvised, thrown together with whatever is around.
marginal - Use the word marginal when something is minimal or barely enough. If you buy lemons and sugar, make lemonade and set up a stand on the street corner, but sell only a couple of glasses, your profits will be marginal.
pending - If something is supposed to happen but hasn’t happened yet, it is pending, like the pending snowstorm that has everyone scrambling to the store for bread and milk.
prescribe - To prescribe is make orders or give directions for something to be done. These days, the word is mainly used by doctors who prescribe medications to take.
preview - A preview gives you a look at something that hasn't been released yet. You see lots of previews at the movies.
prominent - If you're looking for an adjective that means "sticking out above the rest; famous," consider prominent. A prominent person might be the big cheese, the head honcho, the top dog — not just any Joe Schmo.
quaint - Quaint means strange and unusual in an old-fashioned and charming way. It's a word you'd use to describe a little store that sells tea cozies and antique tea services, or your grandmother's habit of calling the radio the "wireless."
reluctant - If the adjective reluctant applies to you, it means that you are undergoing some inner struggle and are unwilling or unable to decide.
scrimp - When you scrimp, you get by on very little money. If you scrimp all year long in order to buy tickets to the Stanley Cup finals, you save every last penny to be able to go to those games.
snare - A snare is a trap, usually for small animals, and using a noose. Snare can also mean to trap in general or any type of trap, like the snare of a TV cliffhanger that traps you into watching again.
utmost - Utmost means "the greatest extent or amount." When you work as hard as you possibly can, you do your utmost to accomplish your goal.
vengeance - If someone hurts you, you might be inspired to plan an act of vengeance: some type of payback in order to settle the score. Be careful, though, because you might inspire someone to take vengeance on you in return.
amiss - When things are out of their proper places or not happening the way they should, we say they are amiss. Sherlock Holmes, like many sharp detectives, would quickly notice when something was amiss at a crime scene.
brawl - A brawl is a noisy fight in a crowd. If the food fight in the cafeteria gets seriously out of hand, you might find yourself in an all-out brawl.
detest - If you detest something, you dislike it intensely. The word can apply to things and also to people. You might detest your ex-boyfriend and you might also detest rainy Mondays and broccoli.
domestic - Domestic generally means relating to someone's family, home, or home country. Domestic work is work done in the home — a domestic is someone who works in a home, such as a nanny or a maid.
flagrant - Something flagrant is bad — so bad you can't ignore it. A flagrant foul in sports might send you to the bench, and a flagrant violation of the law might send you to the slammer.
flaw - A flaw can be a sign of weakness or defect. If you try to make wings and fly off the roof but wind up crashing in the gutter, there's a flaw in your plan.
fledgling - A fledgling is a fuzzy baby bird just learning to fly, or someone (like a baby bird) who's brand new at doing something. Awww.
fluster - To fluster someone is to make them feel upset or agitated. There are many things that might fluster you: giving a speech in front of the whole school, solving a challenging math problem, or even getting a love note from an admirer.
foremost - Foremost is an adjective that means holding the highest position or rank. When naming advisors, presidents usually search for the foremost experts on various subjects.
momentum - Momentum is generally used to mean increasing forward motion. A boulder rolling down a hill gains momentum. So does a great idea, a team on a winning streak, or the economy.
notable - When something is notable, it's worthy of notice, or even famous. It might be a notable feature of your trip to New York City that you spotted one of the city's notable celebrities.
nurture - If you plant a seed, water it daily and give it lots of light, you nurture it until it is ready to be transplanted outside. When you nurture a person or thing, you care for it and help it to grow.
paradox - Here's a mind-bender: "This statement is false." If you think it's true, then it must be false, but if you think it's false, it must be true. Now that's a paradox!
perjury - Perjury is the act of deliberately lying under oath. A defendant in a murder trial commits perjury when he swears he never met the murder victim before, even though he had a two-year relationship with her.
presume - If you presume something, it means you act as though it's true before all the evidence is in. If you are presumed to be the fastest runner, don't get too cocky — that word implies that you haven't actually raced yet.
prior - Generally you should eat dinner prior to brushing your teeth. Use the adjective prior for things that exist earlier in time or that happen first in time or order.
proficient - When someone has become good at something, they are proficient. After all those hours playing video games, you must be very proficient at them.
salvo - A salvo is when troops fire their guns all at the same time. A salvo of shots might signal the beginning of a military battle.
vigilant - Use vigilant to describe someone who keeps awake and alert in order to avoid danger or problems. When taking the subway, be vigilant about your wallet — always know where it is, or someone might steal it from you.
wrath - Wrath is great anger that expresses itself in a desire to punish someone: Noah saw the flood as a sign of the wrath of God.
abnormal - If you get a snowstorm in the middle of July, you could say that you are experiencing “abnormal weather.” Something that is abnormal is out of the ordinary, or not typical.
capsize - To capsize is to overturn, and it usually happens to boats. Don't rock the boat, baby, or you might just capsize.
catastrophe - A catastrophe is a disaster. If a wedding reception is disrupted by a fistfight between the bride and her new mother-in-law, you could call the occasion a catastrophe.
decrease - Decrease means to lower or go down. If you are driving above the speed limit, you should decrease your speed or risk getting a ticket. Students always want teachers to decrease the amount of homework.
disputatious - If you're always looking for a fight, consider yourself disputatious. However, disputatious is more appropriate for the head of the debate team rather than the playground bully.
evict - Use the verb evict to say that a tenant is being forced to move out of his home, usually through legal action. If you don't pay your rent, eventually your landlord will evict you.
flourish - A flourish is an extra touch — a trumpet's "ta-ta-da!" announcing a king's entrance, a fancy carving atop an otherwise utilitarian pillar, a wave of a flag or a cheerleader's pompom.
incentive - If your mom wants you to mow the lawn but you don't feel like it, she might offer to treat you to ice cream after as an incentive. An incentive is something that stimulates you to take action or work harder.
insubordinate - If you want to be insubordinate, go ahead and break the rules, ignore orders, and act like a disobedient rebel.
legible - Legible describes readable print or handwriting. If someone tells you that your writing looks like "chicken scratch," it might not be legible, except to other chickens.
nub - A nub is a little piece of something, especially one that sticks out. The raised rubber buttons on your TV remote control are nubs.
onslaught - Onslaught is a military term that refers to an attack against an enemy. It's safe to say that no one wants to be caught on the receiving end of an onslaught, because there will be lots of danger, destruction and probably death.
ordain - To ordain is to make someone a minister, priest, monk, or other member of the clergy. In the Catholic church, for example, a bishop ordains new priests.
outstrip - While outstrip might make you think about undressing, it really means outdoing. If the productivity of your garden outstrips your neighbor's, expect the neighborhood to come calling for fresh vegetables.
pervade - To pervade means to be present throughout, to exist in every part of. If you have too many cats, the horrible smell of cat pee will pervade your house.
prudent - Describe an action as prudent if it is the wise thing to do under the existing circumstances. If you're getting in trouble, it is probably prudent to keep your mouth closed and just listen.
quench - Quench means to put out, put an end to, or satisfy. If you're stranded in the middle of the desert with nothing to drink, you're probably dreaming of a nice big glass of ice water to quench your thirst.
remnant - A remnant is something that's left over, once the rest is used up. If you plan to sew a shirt using only a remnant, it might have to be a midriff shirt.
simultaneous - The adjective simultaneous describes something that is done at the same time as something else. "The teachers all assigned simultaneous projects to the students that week. The kids were grumbling and sleep-deprived due to the grind."
swerve - The noun swerve means a sudden turn off your path. As a verb, it means to move off your original route, possibly to avoid a collision. You can swerve either toward something or away from it.
accelerate - Accelerate means to speed up. A car accelerates when you step on the gas. You can accelerate the process of getting a visa if you happen to know someone who works in the consulate.
bystander - Someone who observes an event without taking part in it is a bystander. The police may want to interview any bystanders who witnessed a robbery, to get a description of the robber.
canvass - A canvass is a poll, usually a political one. Around elections, political parties often canvass particular neighborhoods, looking for votes and trying to measure the pulse of the people.
casual - "Oh, no, are you kidding me? He's not my boyfriend, we're just in a casual relationship," means that our relationship lacks serious intent or commitment.
downtrodden - Someone who's downtrodden is mistreated by some powerful person or group. An exploited, underpaid worker is downtrodden.
entice - Let's say your friend wants to go to the movies and you don't want to. Your friend might try to entice you by offering to buy you popcorn and a soda. Entice means to persuade with promises of something.
erode - When soil or land erodes, it wears away or is removed. Many beaches seem to get smaller and smaller, as the endless wash of the waves begins to erode the fine sand.
flounder - A flounder is a flat fish with both eyes on one side of its head; and, as a verb, to flounder is to wobble around like a fish out of water.
graphic - Something graphic is visual. Graphic design is made of visual elements. A graphic novel tells its story with pictures. And a story that is too graphic is too good at showing you things that are, for example, shocking or violent.
gruesome - Gothic novels, horror movies, and crime dramas don't shy away from showing gruesome scenes of death, pictures that inspire fright and repulsion. Synonyms include "ghastly," "grisly," "loathsome," and "macabre."
melancholy - Melancholy is beyond sad: as a noun or an adjective, it's a word for the gloomiest of spirits.
ordeal - An ordeal is something difficult or painful to go through. Something kind of hard like taking a test can be an ordeal, but often an ordeal is a serious and long-lasting event, like an illness or tragedy.
parch - If you don't water your lawn all summer, the hot weather will parch the grass until it's brown and withered. To parch is to dry up or wither due to sunlight or heat.
persist - When someone persists they keep going or hang on. If you want finish a marathon, you have to persist and keep running, no matter how many blisters you have.
puny - Are your muscles looking small, weak, and totally inferior? In other words, puny? Sounds like somebody needs to eat more spinach.
quibble - A quibble is a small argument or fight. As a verb, it means to pick a mini-fight over something that doesn't really matter. "Let's not quibble over price," people will say, usually when they plan to gouge you.
ratify - To ratify a treaty or contract is to officially approve it by signing or voting for it. You and your brothers and sisters might devise a plan for a family vacation to Disney World, but it would need to be ratified by your parents.
regal - Even though he was homeless, Dan had a regal bearing. Regal is an adjective that describes things that appear to be royal.
stifle - To stifle is to cut off, hold back, or smother. You may stifle your cough if you don't want to interrupt a lecture or you may stifle the competition if you fear losing.
vital - A patient's vital signs are their important body functions, such as pulse rate, that shows they are still alive. Use the adjective vital to describe something that is important and necessary, or a person full of energy.
bellow - To bellow is to shout in a deep, angry voice. If you constantly bellow at other drivers on the road, consider signing up for anger management classes.
beneficiary - A beneficiary is simply the recipient of money or other benefits. So when your big sister finally moves away to college and you get to move into her bigger bedroom? You become a lucky beneficiary.
botch - If you botch something, you make a mess of it or you ruin it. If you totally botch your lines in the school play, you stammer and stutter your way through the whole thing.
clutter - The word clutter can mean a messy jumble of objects. The disorganized clutter of shoes, hats, shirts, belts, jackets, and pants makes it impossible to find a thing in your closet!
dilapidated - Falling down and in total disrepair, something that's dilapidated is going to need a lot of fixing up.
dismantle - To take something apart or down is to dismantle it. If you dismantle a computer to see what it looks like inside, you better know how to put it back together, or you might be looking at the inside of your room for awhile.
farce - A farce is a broad satire or comedy, though now it's used to describe something that is supposed to be serious but has turned ridiculous. If a defendant is not treated fairly, his lawyer might say that the trial is a farce.
futile - When something fails to deliver a useful result, you can call it futile. Hopefully all the time you're spending studying vocabulary won't turn out to be futile!
grueling - If a job is grueling, that means it is really difficult. If a race is grueling, that means it is really difficult. If a trip to the dentist is grueling, that means you need to toughen up.
hospitable - When someone makes you feel comfortable and at home, that person is being hospitable, providing a warm, friendly environment. Anything hospitable is welcoming and open.
lair - A lair is a wild animal's den. If you ever find yourself in a forest and face to face with a bear trying to lure you into his lair, beware! He may be plotting to eat you.
lavish - Lavish means generous and extravagant as an adjective and to give generously as a verb. If you don't like it when people lavish you with attention, you might appreciate a lavish spread of excellent food instead.
morbid - If the first section of the newspaper you read is the obituaries, you could be considered morbid. Morbid is a word used to describe anyone who spends too much time thinking about death or disease.
notorious - Use the adjective notorious to describe people, places, or things that are famous for a bad reason.
pamper - When you pamper your dog, you spoil him. You might pamper him by feeding him cubes of cheese and knitting him a little sweater and letting him sleep in your bed under the covers.
parasite - A creature that lives off another organism is a parasite. The parasite might not hurt the host, but it doesn't do anything to help it, either.
shirk - To shirk your responsibilities is to avoid dealing with them — like when you watch four consecutive hours of infomercials instead of facing your homework.
surplus - A surplus is something extra or left over. If your tree produces more apples than you can eat, you can make applesauce with the surplus of apples.
timidity - Do you suffer from timidity? If so, you probably feel uneasy in new places and situations. You might fear having to make decisions. But as you get more comfortable, your timidity will go away.
veto - A veto is a no vote that blocks a decision. The President can veto some bills that pass his desk.
adequate - When you want to say that something is enough or good enough for a particular need, use the adjective adequate. You might have an adequate amount of flour for a batch of pancakes, but not a lot extra.
ajar - The adjective ajar describes something that is slightly open. A door that has been left ajar is easily pushed open by the wind or a nosy person.
dialogue - If you land a role in a local play, you will probably have to memorize several lines of dialogue.  If you disagree with how that play is being produced, you may want to open up a dialogue with the director.
emblem - An emblem is a design that stands for a group or a concept. If you’re Scottish, your family may have an emblem such as a coat of arms that symbolizes your heritage.
gigantic - Gigantic is an adjective used to describe something that's really big, as though it were made for a giant. You might call a skyscraper a gigantic building, especially if it towers over other buildings nearby.
havoc - Havoc is a noun that means devastation or total mayhem. Havoc often wreaked by hurricanes, angry mobs, plundering Vikings, and wild parties that get out of control.
hearth - If you are warming yourself by the fireplace, you are sitting by the hearth. The noun hearth refers to a fireplace and the area around it.
implore - You might ask your friend for a loan if you're short a few bucks, but if the bank is about to foreclose on your house you'll implore your friend for the money, desperately begging for the cash so you can keep your house.
infamous - Someone who is infamous has a very bad reputation. If you become a Hollywood star and find yourself on the pages of gossip magazines for your affairs and addictions, you will have succeeded in becoming infamous.
innumerable - Something innumerable can't be counted — there are just too many, like the stars in the sky. Innumerable things are infinite.
lax - Those parents who let their kids eat all their Halloween candy the night of October 31st? Their parenting style might be described as lax. A paperclip chain used as a bike lock? That's an example of lax security.
mar - A mar is a flaw, mark, or blemish, like a deep scratch on a wooden table. As a verb, to mar is to make such an imperfection — like the pen mark that mars your crisp, white shirt.
misdemeanor - A misdemeanor is a minor offense, rather than a serious crime. A minor infraction like keeping a library book for years or stealing a pack of bubblegum would be considered a misdemeanor.
mull - The verb mull means to think deeply about something, the way you might mull over your choice of what college to attend.
narrative - A narrative is a story that you write or tell to someone, usually in great detail. A narrative can be a work of poetry or prose, or even song, theater, or dance.
overture - An overture is a piece of music played by an orchestra at the beginning of an opera or play. When an overture begins, the actors take their places and wait for the curtain to rise.
pact - A pact is a treaty or other agreement between parties, and it's usually written. Countries can have pacts or you can make a pact with your friends, promising each other that you'll all show up for the spelling bee.
stalemate - A stalemate is an impasse in a contest, a point where neither player — usually in chess — can win or lose.
vindictive - It is no fun hanging out with vindictive people, who are forever out to get back at people they think have hurt them. If you forget to say hello to them one day in the hall, they will carry a grudge against you into next week.
wilt - When things droop from heat, lack of water, or illness, they wilt. If you go on vacation for two weeks and forget to water your plants first, they will wilt.
abound - When things abound, there are a lot of them. In spring, birds, flowers, rain, and frisbees abound.
braggart - If you know someone who is a real show off and is always bragging about how great they are, then you might call this boaster a braggart.
cache - Cache sounds like what it is, a stash, and sometimes people — usually the criminal type — have a cache of stolen cash.
clarification - Clarification is what you hope to achieve when you make an idea or concept less confusing and easier to understand. This often happens after a detailed or very clear explanation.
despondent - If you are despondent, you are discouraged, very sad, and without hope. If you are depressed, you might describe your mood as despondent.
embezzle - When a person embezzles, it usually means that he is stealing money from his employer. If he is caught embezzling, it probably also means that he will soon be unemployed.
heartrending - Something heartrending is heartbreaking: it causes grief and sadness.
leisurely - Leisurely is a word that describes something that is unhurried and easygoing, like the leisurely bike ride you may take home when you know have a lot of work waiting for you there.
lethargic - When you feel lethargic, you're sluggish or lacking energy. Being sleepy or hungry can make anyone lethargic.
malady - A malady is an illness, like a malady that keeps you home, sick in bed for days, or something that causes you to have trouble or to suffer, like jet lag — a malady that affects travelers.
mellow - When something becomes mellow, it gets softer or more relaxed. People are often said to mellow with age, meaning their aggressiveness, their sarcasm, and their short temper have given way to a more easygoing, genial manner.
nomadic - A nomad is someone who lives by traveling from place to place. Nomadic thus means anything that involves moving around a lot. Nomadic hunter-gatherer tribes follow the animals they hunt, carrying tents with them.
piecemeal - When you do something piecemeal, you're doing it little by little, but in a seemingly random way, with no order or system.
quest - A quest is all about seeking something important, and it often involves a journey. You would travel the world in a quest for gold. You would not travel to the front of the lunchroom in a quest for tater tots.
random - Something that’s random is lacking in order, plan, or purpose. It happens totally by chance, like the random picking of lottery numbers or unplanned random acts of kindness.
rant - A rant is an argument that is fueled by passion, not shaped by facts. When the shouting starts on talk radio, or when a blog commenter resorts to ALL CAPS, you're almost certainly encountering a rant.
reinforce - To reinforce means to make stronger. You can reinforce your roof by putting some extra supports under it.
seclusion - Seclusion means being separate, and apart from others, in a quiet kind of way. If you want seclusion, try a private island.
status - If someone wants to know the status of something, they want to know what condition it's in, where it is, or how much progress it's made. You've probably checked the status of your flight to see if it's on time or delayed.
turmoil - Mashed potatoes flew in one direction, peas in another. Kids were standing on chairs. The principal was shouting, but no one listened. "Food fight!" the seniors cried. The cafeteria was in a state of turmoil.
agitation - Agitation is the act of stirring things up, like the agitation of a washing machine that moves the water, detergent, and clothes around and gets the dirt out or the agitation of political activists who want people to work together to do something.
blurt - If you blurt something out, you're speaking abruptly and without thinking about what you're saying.
chronological - If you’re making a list of all your teachers in the order you had them, from kindergarten right up to the present, you’re listing them in chronological order. Chronological is the order in which things actually happened.
countenance - The noun countenance means the face or its expression. If you're a great poker player, you probably have a calm countenance.
diminish - Diminish means to make smaller or lesser. If you cover a lightbulb with a dark lamp shade, the light from the lamp will diminish.
enchant - To enchant is to cast a spell over someone, like a witch might do. It also means to attract or catch someone's attention in a less mystical way.
fluctuate - Something that fluctuates varies or changes — it's the opposite of steady. Like the ups and downs of the stock market or the relationship status of a Hollywood starlet.
foster - To foster is to nurture something. A teacher could foster creativity by providing crayons to every student. You can also foster a child, which means the child lives in your home for a time.
grovel - To grovel is to beg like a hungry dog. You don't have to be a canine though; you might grovel for a better grade (please don't).
handicraft - Something you make with your own hands, especially an ornament or decoration, is a handicraft. You might buy some local handicrafts on your trip to Mexico, like woven bags or handmade toys, as gifts for your family.
hilarious - One person can find a joke a little funny, while someone else might find it downright hilarious. When something is super-funny, it's hilarious.
ignite - Ignite is a verb that means to start heat or a flame. Trying to ignite a match inside a dark fireworks factory is a really bad idea — one that can get you blown sky high.
magnitude - Earthquakes have great magnitude in that they are powerful. Their power is rated by their level of magnitude, or how much energy they release relative to other earthquakes.
massive - Massive means enormous. Obviously, Mt. Everest is massive, but a massive budget cut isn't necessarily big in physical mass; it's something that is imposing in scale or power. A massive budget cut can do a lot of damage.
maternal - If you are maternal, you are like a mother.  How you define what it is to be “like a mother” is up to you, but most people think of nurturing things like chicken soup and kisses on the forehead.
pall - A pall was originally a coffin’s cloak. Now pall usually means that an event or situation is — literally or figuratively — covered in gloom, like disappointing news that casts a pall on your day.
reputable - Want the real scoop on your favorite singer's latest romance? Then you should probably find a more reputable source than the tabloids — meaning someone with a better reputation, in this case for telling the truth.
revere - Revere means to respect someone so deeply that you almost worship them. Many Americans revere civil rights activists like Martin Luther King, Jr. and Rosa Parks, who worked to make the country a more just place.
saga - When your friend tells you every detail of how she tripped over a rock, broke her ankle, and then got into a car accident on the way to the hospital, she is sharing a long, involved story known as a saga.
stodgy - The Queen's guards outside Buckingham Palace might seem stodgy (or stuffy and stuck-up), but they are only doing their job.
affliction - An affliction makes you suffer, but you have to deal with it anyway. Diseases are often said to be afflictions, but the word can mean just about anything that causes great suffering.
akin - If two things are akin, then they're similar or related. A cupcake is akin to a cake and relatives are akin to each other.
cosmopolitan - Your Aunt Eleanor, who's lived in six different countries and speaks four languages fluently, might be described as cosmopolitan, or comfortable and familiar with different cultures and people.
elongate - 
gala - A gala is a big party. If you're going to a gala, you'll want to wear your fanciest ball gown — you'll want to look great for the best party of the year.
gaudy - Something that's gaudy is showy, bright and definitely tacky. So think twice about that gaudy rainbow-colored suit and shiny gold shoes ensemble.
gratitude - Gratitude means thanks and appreciation. It's the warm feeling you get when you remember the person who told you to drop your 1980s hairstyle and get with the new millennium already.
heed - Heed is an old word, meaning "to listen to and follow." It can also be used as a noun: "Take heed of my instructions," said the wizard, "for the magic potion will work only by the light of the full moon."
hoax - If you put on big fake feet, stomp through your muddy backyard and tell everyone you saw Bigfoot fixing a steak on your grill, you are playing a hoax on your friends.
impartial - If you're in a contest, you'd better hope the judges are impartial. That means that they aren't biased toward one competitor over another.
impostor - 
inflate - Using your own breath or an air pump, you can inflate a balloon — or anything else you need to pump air into. When you inflate something you fill it with air (or any other gas) to make it expand.
meager - Meager means small and often applies to portions. Your mother may only allow you a meager serving of chocolate cake, and you may need to eat a meager serving of veggies in order to deserve that dessert.
meditate - When you meditate, you silently calm or focus your mind for relaxation or spiritual reasons. People who meditate regularly can put a stop to racing thoughts, making them less distracted.
nutritious - Nutritious describes food that's good for you. Brown rice and kale are nutritious, but jelly beans, sadly, are not.
oppress - When you oppress someone, you use your authority to keep them down. If you oppress people long enough, they might decide to fight back and then decide to oppress YOU.
pedestrian - A pedestrian is someone traveling by foot. If you're a pedestrian, you will likely get annoyed at the drivers who don't stop so you can cross the street.
transmit - If you’re an international spy, you might transmit secret messages using a special code written in invisible ink. If you aren’t a spy, you could probably just use email. Whatever your circumstances, when you transmit information, you send.
vanquish - To vanquish is to be the complete and total winner, to overpower and overcome, whether in a contest, a race, or a war. It generally suggests a total trouncing, to the point of humiliation — or worse — for the loser.
wan - Someone who is wan is visibly unwell and lacking in energy. If you’ve had the flu for over a week, and you finally get out of bed looking pale and tired, your mother might say that you look wan.
authoritative - Speak with an authoritative tone, or no one will listen to you. Why would they, if you sound like you don't even believe in yourself? Authoritative means sure or definitive.
bankrupt - You might not have any money in your pocket, but it doesn’t necessarily mean you are bankrupt. It takes a legal proceeding for the courts to declare a person bankrupt — or officially unable to pay his debts.
clamor - To clamor is to make a demand — LOUDLY. It's usually a group that clamors — like Americans might clamor for comprehensive health care coverage.
coincide - When things happen at the same time, they are said to coincide. Often, this is because they're intentionally coordinated — "the bake sale coincided with Parent Day" — but not always.
cynical - If you think public officials are nothing but a bunch of greedy buffoons, you have a cynical attitude about politics.
despot - A despot, is a cruel, all-controlling ruler. For example, a despot does not allow people to speak out against the leadership, nor really want them to have much freedom at all.
feud - A feud is a long-standing fight, often between two families. In Romeo and Juliet, Shakespeare describes the lovers' long-feuding families, the Capulets and the Montagues.
haggle - If you want a great deal on a used TV, then you can try to haggle with the sellers to see if they’ll bring the price down. To haggle is to negotiate or argue over something, usually a price.
hardy - Hardy means tough––if you're hardy, you don't get tired easily and can endure hardship. People who don't catch cold often attribute this fact to their coming from hardy farming stock.
harmonious - Things that are harmonious go together nicely, like notes in music or people that work well as a team.
hoard - To hoard is to save something (or lots of things) for future use. Squirrels hoard nuts for the winter. Old ladies tend to hoard canned food and used plastic bags.
indisposed - The adjective indisposed is a slightly formal way to describe someone who's feeling sick. You might call your boss to tell her that you can't make it to work because you're indisposed.
legacy - Use the word, legacy, for something handed down from one generation to the next. A retiring company president might leave a legacy of honesty and integrity.
legitimate - Something legitimate is the real deal — according to the law.
mirth - Mirth is a formal or literary term meaning fun and enjoyment as shown by laughter. If you and your friends stayed up all night at a sleepover laughing, you might refer to that as a night of mirth.
officiate - To officiate is to preside over a ceremony, or to be the person in charge. At most weddings, a religious leader or judge officiates.
partial - If you describe something as partial, you're usually saying it's just part of the whole, or incomplete.  Say someone asks how you started your band and you say, "I bought a guitar." That would be a partial answer, at best.
patronize - If you patronize a business, you shop there regularly. But if someone patronizes you, it's not so pleasant — they talk to you as if you were inferior or not very intelligent.
rite - A rite is a ceremony or event that leads to a new phase of life, like high school graduation or a bat mitzvah.
sagacious - Use the formal adjective sagacious to describe someone who is wise and insightful like an advisor to the president or a Supreme Court justice.
